000000000000000000000000000000000000000000000000000000000000
000000001100000000000000000000000000000000000000000000000000
000000001100000000000000000000000000000011000000000000000000
000000001100001100000000000000000011000011000000000000000000
001100001100001100000000000000000011000011001111111111111110
001100001100001100000000000000000011000011001111111111111110
001100001100001100000011111111110011000011000000000000000000
001100001100001100000011111111110011000011000000000000000000
001100001100001100000000000000000011000011000000000000000000
001100001100001100000000000000000011000011000000000000000000
001100001100001100000000110000000011000011000000000000000000
001100000000001100000000110000000011000011000000000000000000
001100000000001100000000110000000011000011001111111111000000
001100000000000000000000110000000000000011001111111111000000
000000000000000000000000110000000000000011000000000000000000
000000000000000000000000110000000000000011000000000000000000
000011111111110000001100110000000000000011000000000000000000
000011111111110000001100110000000011000000000000000000000000
000000000000000000001100110000110011000000000000000000000000
000000000000000000001100110000110011001111111111000000000000
000000000000000000001100110000110011001111111111000000000000
001111111111000000001100110000110011000000000000000000000000
001111111111000000001100110000110011000000000000000000000000
000000000000000000001100110000110011000000000000000000000000
000000000000000000001100110000110011000000001111111111000000
000000000000000000001100000000110011000000001111111111000000
000000000000000000000000000000110011000000000000000000000000
000000000000000000000000000000110000000000000000000000000000
000000000000000000000000000000000000000000000000000000000000
000000000000000000000000000000000000000000000000000000000000
