000000000000000000000000000000000000000000000000000000000000
000000000000000000000000000000000000000000000000000000000000
000000000000000000000000000000000000000000000000000000000000
000011111111111111111111000000000000000000000011111111110000
000011111111111111111111000000110000000000000011111111110000
000000000000000000000000000000110000000000000000000000000000
000000000000000000000000000000110000000000000000000000000000
001111111111000000000000000000110000000000001111111111111110
001111111111000000000000000000110000001100001111111111111110
000000000000000000000000000000110000001100000000000000000000
000000000000000000111111111100110000001100000000000000000000
000000000000000000111111111100110000001100000000000000000000
000000000000000000000000000000110000001100000000000000000000
000000000000000000000000000000110000001100000011111111110000
000000000000000000000000000000000000001100000011111111110000
001111111111000000000000000000000000001100000000000000000000
001111111111000000000000000000000000001100000000000000000000
000000000000000000000000000000000000001100000000000000000000
000000000000000000000000000000001100001100000000110000000000
000000000000111111111111111000001100001100000000110000000000
000000000000111111111111111000001100001100000000110000000000
000000000000000000000000000000001100001100000000110000000000
000000000000000000000000000000001100001100000000110000000000
000000000000000000000000000000001100001100000000110000000000
000000000000000000000000000000001100001100000000110000000000
000000111111111111111111110000001100001100000000110000000000
000000111111111111111111110000001100001100000000110000000000
000000000000000000000000000000001100001100000000110000000000
000000000000000000000000000000000000000000000000000000000000
000000000000000000000000000000000000000000000000000000000000
