000000000000000000000000000000000000000000000000000000000000
000000000000000000000011000000000000000000000000000000000000
000000111111111111111011001111111111111111111100000000000000
000000111111111111111011001111111111111111111100000000000000
000000000000000000000011000000000000000000000000000000000000
000000000000000000000011000000000000000000000000000000000000
001111111111000000000011000000000000000000000000000000000000
001111111111000000000011000011111111110000001111111111111110
000000000000000000000011000011111111110000001111111111111110
000000000000000000000011000000000000000000000000000000000000
000000000000000000000011000000000000000000000000000000000000
000000000000000000000000000000001111111111111110000000000000
001111111111111110000000000000001111111111111110000000000000
001111111111111110000000000000000000000000000000000000000000
000000000000000000000000000000000000000000000000000000000000
000000000000000000000000001100000000000000000000000000000000
000000000000000000000000001100000000000000000000000000000000
000000001111111111000000001100110000000011111111111111100000
000000001111111111000000001100110000000011111111111111100000
000000000000000000000000001100110000000000000000000000000000
000000000000000000000000001100110000000000000000000000000000
000000000000000000000000001100110000000000000000000000000000
000000000000000000000000001100110000000000000000000000000000
000000111111111111111000001100110000000000000000000000000000
000000111111111111111000001100110000000000000000000000000000
000000000000000000000000000000110000000000001111111111000000
000000000000000000000000000000110000000000001111111111000000
000000000000000000000000000000000000000000000000000000000000
000000000000000000000000000000000000000000000000000000000000
000000000000000000000000000000000000000000000000000000000000
