000000000000000000000000000000000000000000000000000000000000
000011000000000000000000000000000000000000000000000000000000
000011000011111111110000000000000000000000000000000000000000
000011000011111111110000000000000000000000000000000000000000
000011000000000000000000111111111111111000000000000000000000
000011000000000000000000111111111111111000000000000000000000
000011000000000000000000000000000000000000000011111111110000
000011000000000000000000000000000000000000000011111111110000
000011001111111111111111111100000000000000000000000000000000
000011001111111111111111111100000000000000000000000000000000
000011000000000000000000000000000000000000000000000000000000
000000000000000000000000000000000000000000000000000000000000
000000000000000000000000000000000011111111110000000000000000
000000000011111111111111111111000011111111110000000000000000
000000000011111111111111111111000000000000000000000000000000
000000000000000000000000000000000000000000000000000000000000
000000000000000000000000000000000000000000000000111111111100
000000000000000000000000000000111111111111111000111111111100
000000000000000000000000000000111111111111111000000000000000
000000000000000000000000000000000000000000000000000000000000
000000000000000000000000000000000000000000000000111111111100
000000000000000000000000000000000000000000000000111111111100
000000000000000000111111111100001111111111000000000000000000
000000000000000000111111111100001111111111000000000000000000
001111111111111110000000000000000000000000000000000000000000
001111111111111110000000000000000000000000000000000000000000
000000000000000000000000000000000000000000000000000000000000
000000000000000000000000000000000000000000000000000000000000
000000000000000000000000000000000000000000000000000000000000
000000000000000000000000000000000000000000000000000000000000
