000000000000000000000000000000000000000000000000000000000000
000011000000000000000000000000000000000000000000000000000000
000011000000000000000000000000000000000000111111111111111000
000011000000000000111111111100000000000000111111111111111000
000011000000000000111111111100000000000000000000000000000000
000011000000000000000000000000000000000000000000000000000000
000011000000000000000000000000000000000000000000001100110000
000011000000000000000011111111111111111111000000001100110000
000011000000000000000011111111111111111111000000001100110000
000011000000000000000000000000000000000000000000001100110000
000011000000000000000000000000000000000000000000001100110000
000000000000000000000000000000000000000000000000001100110000
000000000000000000000000000011111111111111111111001100110000
000000000000001111111111000011111111111111111111001100110000
001111111111001111111111000000000000000000000000001100110000
001111111111000000000000000000000000000000000000001100110000
000000000000000000000000000000000000000000000000000000000000
000000000000000000000000000000000000000000000000000000000000
001111111111000000000000000000000000000000000000000000000000
001111111111000000000000000000111111111100000011111111110000
000000000000000000000000000000111111111100000011111111110000
000000000000000000000000000000000000000000000000000000000000
000000000000111111111111111000000000000000000000000000000000
000000000000111111111111111000000000000000000000000000000000
000000000000000000000000000000111111111100000000000000000000
000000000000000000000000000000111111111100001111111111000000
000000000000000000000000000000000000000000001111111111000000
000000000000000000000000000000000000000000000000000000000000
000000000000000000000000000000000000000000000000000000000000
000000000000000000000000000000000000000000000000000000000000
