000000000000000000000000000000000000000000000000000000000000
001100000000000000000000000000000000000000000000000000000000
001100001111111111000000000011111111111111111111000000000000
001100001111111111000000000011111111111111111111000000000000
001100000000000000000000000000000000000000000000000000000000
001100000000000000000000000000000000000000000000000000000000
001100001111111111111111111100000000000000000000000000000000
001100001111111111111111111100000000000000000000000000000000
001100000000000000000000000000000000000000000000000000000000
001100000000000000000000000000000000000000000000000000000000
001100000000000000000000000000000000000000001111111111111110
000000000000000000000000111111111111111000001111111111111110
000000000000000000000000111111111111111000000000000000000000
000000001111111111000000000000000000000000000000000000000000
000000001111111111000000000000000000000000000000000000001100
000000000000000000000000000000000000000000000000000000001100
000000000000000000000000000000000000000000000000000000001100
000011111111111111111111000000000011111111111111100011001100
000011111111111111111111000000000011111111111111100011001100
000000000000000000000000000000000000000000000000000011001100
000000000000000000000000000000000000000000000000000011001100
000000000000000000000000000000000000000000000000000011001100
000000000000000000000000000000000000000000000000000011001100
000000000000000000000000000011111111111111100000000011001100
000000000000111111111100000011111111111111100000000011000000
000000000000111111111100000000000000000000000000000011000000
000000000000000000000000000000000000000000000000000011000000
000000000000000000000000000000000000000000000000000000000000
000000000000000000000000000000000000000000000000000000000000
000000000000000000000000000000000000000000000000000000000000
