000000000000000000000000000000000000000000000000000000000000
000000000000110000000000000000000000000000000000000000000000
001100000000110000000000000000000000000000000000000000000000
001100000000110000000000000000000000000000000000000000000000
001100000000110000000000000000000000000000000000000011000000
001100000000110000000000001111111111111110000000000011001100
001100000000110011000000001111111111111110000000000011001100
001100000000110011000000000000000000000000000000000011001100
001100000000110011000000000000000000000000000000000011001100
001100000000110011000000000000000000000000000000000011001100
001100000000110011000000000000000000000000000000000011001100
001100000000000011000000000011111111111111111111000011001100
000000000000000011000000000011111111111111111111000011001100
000000000000000011000000000000000000000000000000000011001100
000000000000000011000000000000000000000000000000000011001100
000000110000000011000000000000000000000000000000000011001100
000000110000000000000000000000000000000000000000000011001100
000000110000000000000000000000111111111100000000000011001100
000000110000000000000000000000111111111100000000000011001100
000000110000111111111100000000000000000000000000000011001100
000000110000111111111100000000000000000000000000000011000000
000000110000000000000000000000000000000000000000000011000000
000000110000000000000000000000000000000000000000000011000000
000000110000000000000000000000000000000000000000000011000000
000000110000000011111111110000001111111111000000000000000000
000000000000000011111111110000001111111111000000000000000000
000000000000000000000000000000000000000000000000000000000000
000000000000000000000000000000000000000000000000000000000000
000000000000000000000000000000000000000000000000000000000000
000000000000000000000000000000000000000000000000000000000000
