000000000000000000000000000000000000000000000000000000000000
000000000000000000000000000000000000000000000000000000000000
000000000000000000000000000000000000000000000000000000000000
000000000000000000000000000000000011111111110000000000000000
001111111111000000000000000000000011111111110000000000000000
001111111111000000110000000000000000000000000000000000000000
000000000000000000110000000000000000000000000000111111111100
000000000000000000110000000000000000000000000000111111111100
000000111111111100110000000000000000000000000000000000000000
000000111111111100110000111111111100000000000000000000000000
000000000000000000110000111111111100000011111111111111100000
000000000000000000110000000000000000000011111111111111100000
000000000000000000110000000000000000000000000000000000000000
000011111111110000110000000000000000000000000000000000000000
000011111111110000110000000000001111111111000000000000000000
000000000000000000110000000000001111111111000000111111111100
000000000000000000110000000000000000000000000000111111111100
000000000000000000110000000000000000000000000000000000000000
000000000000000000110000000000000000000000000000000000000000
000011111111110000110000000000000000000000000011111111110000
000011111111110000000000000000000000000000000011111111110000
000000000000000000000000000000000000000000000000000000000000
000000000000000000000000000000000000000000000000000000000000
001111111111111111111100000011111111110000000000000000000000
001111111111111111111100000011111111110000000000000000000000
000000000000000000000000000000000000000000111111111111111000
000000000000000000000000000000000000000000111111111111111000
000000000000000000000000000000000000000000000000000000000000
000000000000000000000000000000000000000000000000000000000000
000000000000000000000000000000000000000000000000000000000000
