000000000000000000000000000000000000000000000000000000000000
000000000000000000000000000000000000000000000000000000000000
000000110000111111111111111111110000000000000000000000000000
000000110000111111111111111111110011111111111111100000000000
000000110000000000000000000000000011111111111111100000000000
000000110000000000000000000000000000000000000000000000110000
000000110000000000000000000000000000000000000000000000110000
000000110000000000000000000000000000000000000000000000110000
000000110000000000000000000000000000000000000000000000110000
001100110000000000000000000000000000000000000000000000110000
001100110000000011111111111111100000000000000000000000110000
001100110000000011111111111111100000111111111111111000110000
001100000000000000000000000000000000111111111111111000110000
001100000000000000000000000000000000000000000000000000110000
001100000000000000000000000000000000000000000000000000110000
001100000000000000000000000000000011111111111111100000110000
001100001111111111111110000000000011111111111111100000110000
001100001111111111111110000000000000000000000000000000110000
001100000000000000000000000000000000000000000000000000110000
000000000000000000000000000000000000000000000000000000110000
000000000000000000000000000000000000000000000000000000110000
000000000000000000000000000000000000000000000000000000110000
000000000000000000111111111100000000000000000000000000110000
000000000000000000111111111100000000000000000000000000110000
000000000000000000000000000000000011111111111111100000110000
000000000000000000000000000000000011111111111111100000000000
000000000000000000000000000000000000000000000000000000000000
000000000000000000000000000000000000000000000000000000000000
000000000000000000000000000000000000000000000000000000000000
000000000000000000000000000000000000000000000000000000000000
