000000000000000000000000000000000000000000000000000000000000
000000000000000000000000000000000000000000000011000000110000
001100000000000000000000000000000000000000000011001100110000
001100000000000000000000001111111111111110000011001100110000
001100000000000000000000001111111111111110000011001100110000
001100110000000000000000000000000000000000000011001100110000
001100110000110000000000000000000000000000000011001100110000
001100110000110000000000000000000000000000000011001100110000
001100110000110000000000000000000000000000000011001100110000
001100110000110000111111111111111111110000000011001100110000
001100110000110000111111111111111111110000000011001100110000
001100110000110000000000000000000000000000000000001100110000
001100110000110000000000000000000000000000000000000000110000
001100110000110000000000000000000000000000000000000000110000
001100110000110000000000000000111111111111111111110000110000
001100000000110000000000000000111111111111111111110000110000
001100000000000000000000000000000000000000000000000000110000
000000000000000000000000000000000000000000000000000000110000
000000000000000000000000000000000000000000000000000000110000
000000000000000000000000000000000000001111111111111110110000
000000000000000000000000000000000000001111111111111110110000
000000000000000000000000000000000000000000000000000000000000
000000001111111111111111111100000000000000000000000000000000
000000001111111111111111111100000000000000000000000000000000
000000000000000000000000000000000011111111111111111111000000
000000000000000000000000000000000011111111111111111111000000
000000000000000000000000000000000000000000000000000000000000
000000000000000000000000000000000000000000000000000000000000
000000000000000000000000000000000000000000000000000000000000
000000000000000000000000000000000000000000000000000000000000
