000000000000000000000000000000000000000000000000000000000000
000000000000000000000000000000000000000000000000000000000000
000000000000000000000000000000001111111111001111111111111110
000000000000000000000000110000001111111111001111111111111110
000000000000000000000000110000000000000000000000000000000000
000000000000110000000000110000000000000000000000000000000000
000000000000110000001100110000000000000000000000000000000000
000000000000110000001100110000000000000000000000000000000000
000000000000110000001100110000000000000000000000000000000000
000000000000110000001100110000001111111111111110000000000000
000000110000110000001100110000001111111111111110000000000000
000000110000110000001100110000000000000000000000000000000000
000000110000110000001100110000000000000000000000000000000000
000000110000110000001100110000000000000000000000000000000000
000000110000110000001100110000000000000000000000000000000000
000000110000110000001100110000000011000000000000000000110000
000000110000110000001100110000000011000000000000000000110000
000000110000110000001100110000000011000000000011000000110000
000000110000110000001100110000000011000000000011000000110000
000000110000110000001100110000000011000000000011000000110000
000000000000000000001100110000000011000000000011000000110000
000000000000000000001100110000000011000000000011000000110000
000000000000000000001100110000000011000000000011000000110000
000011111111111111101100000000000011000000000011000000110000
000011111111111111101100000000000011000000000011000000110000
000000000000000000001100000000000000000000000011000000000000
000000000000000000000000000000000000000000000011000000000000
000000000000000000000000000000000000000000000000000000000000
000000000000000000000000000000000000000000000000000000000000
000000000000000000000000000000000000000000000000000000000000
