000000000000000000000000000000000000000000000000000000000000
000000000000000000000000000000000000000000000000000000000000
000000000000000000000000000000000000000011111111110000000000
000000000000000000000000000000000000000011111111110000000000
000000000011111111111111100011111111110000000000000000000000
000000000011111111111111100011111111110000000000000000000000
000000000000000000000000000000000000000000000000000000000000
000000000000000000000000000000000000000000000000000000000000
000000000000000000000000000000000000000000111111111111111000
000000000000000000000000000000000000000000111111111111111000
001111111111000000000000000000000000000000000000000000000000
001111111111000000000000000000000000000000000000000000000000
000000000000000000000000110000000000111111111111111000000000
000000000000000000000000110000000000111111111111111000000000
000000111111111100000000110000000000000000000000000000000000
000000111111111100000000110000000000000000000000000000001100
000000000000000000001100110000000000000000000000000000001100
000000000000000000001100110000000000000000001111111111001100
000000000000000000001100110000110000000000001111111111001100
000000000000000000001100110000110000000000000000000000001100
001111111111111110001100110000110000000000000000000000001100
001111111111111110001100110000110000111111111100000000001100
000000000000000000001100110000110000111111111100000000001100
000000000000000000001100110000110000000000000000000000001100
000000000000000000001100110000110000000000000000000000001100
000000000000000000001100110000110000000000000000000000000000
000000000000000000000000110000110000000000000000000000000000
000000000000000000000000000000110000000000000000000000000000
000000000000000000000000000000000000000000000000000000000000
000000000000000000000000000000000000000000000000000000000000
