000000000000000000000000000000000000000000000000000000000000
000000000000000000000000000000000000000000000000000000000000
000000000000000000000000000000000000000000000000000000000000
000000000000000000000000000000000000000000000000110000000000
000000110000000000000000000000111111111111111000110000000000
000000110000000000110000000000111111111111111000110000000000
000000110000000000110000000000000000000000000000110000000000
000000110000000000110000000000000000000000000000110000000000
000000110000001100110000001111111111111110000000110000001100
000000110000001100110000001111111111111110000000110000001100
001100110000001100110000000000000000000000000000110000001100
001100110000001100110000000000000000000000000000110000001100
001100110000001100110000000000000000000000000000110000001100
001100110000001100110000000000000000000000000000000000001100
001100110000001100110000000000000000000000000000000000001100
001100110000001100110000000000111111111100110000000000001100
001100110000001100110000000000111111111100110000000000001100
001100110000001100110000000000000000000000110000110000001100
001100110000000000110000000000000000000000110000110000000000
001100110000000000110000111111111100000000110000110000000000
000000110000000000000000111111111100000000110000110000000000
000000110000000000000000000000000000000000110000110000000000
000000110000000000000000000000000000000000110000110000000000
000000110000000000000000000000000000000000110000110000000000
000000000000001111111111000000000000000000110000110000000000
000000000000001111111111000000000000000000000000110000000000
000000000000000000000000000000000000000000000000110000000000
000000000000000000000000000000000000000000000000000000000000
000000000000000000000000000000000000000000000000000000000000
000000000000000000000000000000000000000000000000000000000000
