000000000000000000000000000000000000000000000000000000000000
000000000000000000001100000000000000000000000000000000000000
000000000000000000001100000000000000000000000000000000000000
000000000000000000001100111111111111111000000000000000000000
001111111111000000001100111111111111111000000000000000000000
001111111111000000001100000000000000000000000000000000000000
000000000000000000001100000000000000000000000000000000000000
000000000000000000001100111111111100000000111111111100000000
000000001100000000001100111111111100000000111111111100000000
000000001100000000001100000000000000000000000000000000000000
000000001100000000001100000000000000000000000000000000000000
000011001100000000000000000000000000001111111111111110000000
000011001100000000000000000000000000001111111111111110000000
000011001100001111111111000000000000000000000000000000000000
000011001100001111111111000000000000000000000000000000000000
000011001100000000000000000000000000000000000000000000000000
000011001100000000000000000000000000000000000000000000000000
000011001100000000000000000000000000000000000000000000000000
000011001100000000000000000000000011111111111111111111000000
000011001100000000111111111100000011111111111111111111000000
000011001100000000111111111100000000000000000000000000000000
000011001100000000000000000000000000000000000000000000000000
000011001100000000000000000000000000000000000000000000000000
000011001100000000000000000000000000000000000000000000000000
000011001100000000000000111111111111111111110000000000000000
000011001100000000000000111111111111111111110000000000000000
000000001100000000000000000000000000000000000000000000000000
000000001100000000000000000000000000000000000000000000000000
000000000000000000000000000000000000000000000000000000000000
000000000000000000000000000000000000000000000000000000000000
