000000000000000000000000000000000000000000000000000000000000
000000000000000000000000000000000000000000001100000000001100
000000000000000000000000000000000000000011001100000000001100
000011000000000000000000000000000000000011001100000000001100
000011000000000011111111111111100000000011001100001100001100
000011000011000011111111111111100000000011001100001100001100
000011000011000000000000000000000000000011001100001100001100
000011000011000000000000000000000000000011001100001100001100
000011000011000000000000000000000000000011001100001100001100
000011000011000000000000110000001100000011001100001100001100
000011000011000000000000110000001100000011001100001100001100
000011000011000000000000110000001100000011001100001100001100
000011000011000000000000110000001100000011001100001100001100
000011000011000000000000110000001100000011001100001100001100
000011000011000000000000110000001100000011001100001100001100
000011000000000000000000110000001100000011001100001100001100
000011000000000000000000110000001100000011001100001100000000
000011000000000000000000110000001100000011001100001100000000
000011000000000000000000110000001100000011001100001100000000
000011000000111111111100000000001100000011001100000000000000
000011000000111111111100000000001100000011001100000000000000
000011000000000000000000000000001100000011000000000000000000
000011000000000000000000000000001100000000000000000000000000
000000000000000011111111110000001100000000000000000000000000
000000000000000011111111110000000000000000000000000000000000
000000000000000000000000000000111111111111111111110000000000
000000000000000000000000000000111111111111111111110000000000
000000000000000000000000000000000000000000000000000000000000
000000000000000000000000000000000000000000000000000000000000
000000000000000000000000000000000000000000000000000000000000
