000000000000000000000000000000000000000000000000000000000000
000000000000000000000000001100000000000000000000000000000000
000000000000000000000000001100000000000000000000000000000000
000000110000001100000011001100000000000000000000000000000000
000000110000001100000011001100000000000000000000000000000000
000000110000001100000011001100000000000000111111111100000000
000000110000001100000011001100001100110000111111111100000000
000000110000001100000011001100001100110000000000000000000000
000000110000001100000011001100001100110000000000000000000000
000000110000001100000011001100001100110000000000000000000000
000000110000001100000011001100001100110000111111111111111000
000000110000001100000011001100001100110000111111111111111000
001100110000001100000011001100001100110000000000000000000000
001100110000000000000000001100001100110000000000000000000000
001100110000000000000000001100001100110000000000000000000000
001100110011111111110000001100001100110000000000000000000000
001100110011111111110000000000001100000000000000000000000000
001100110000000000000000000000001100000000000000000000000000
001100000000000000000000000000001100000000000000000000000000
001100000000000000000000000000001100000000000000000000000000
001100000000000011111111111111101100000000000000000000000000
001100000000000011111111111111100000000000111111111100000000
000000000000000000000000000000000000000000111111111100000000
000000000000000000000000000000000000000000000000000000000000
000000000000000000000000001111111111111110000000000000000000
000000111111111111111000001111111111111110000000000000000000
000000111111111111111000000000000000000000000000000000000000
000000000000000000000000000000000000000000000000000000000000
000000000000000000000000000000000000000000000000000000000000
000000000000000000000000000000000000000000000000000000000000
