000000000000000000000000000000000000000000000000000000000000
000000000000000000000000000000000000000000000000000000000000
000000110000000000000000000000000000000000000000000000000000
000000110000000011111111111111111111000000000000000000000000
001100110000000011111111111111111111000000000000000000000000
001100110000000000000000000000000000000000111111111100000000
001100110000110000000000000000000000000000111111111100000000
001100110000110000000000000000000000000000000000000000000000
001100110000110011000000000000000000000000000000000000000000
001100110000110011000000000000000000000000000000000000000000
001100110000110011000000000011111111111111100000000000000000
001100110000110011000000000011111111111111100000000000000000
001100000000110011000000000000000000000000000000000000000000
001100000000110011000000000000000000000000000000000000000000
001100000000110011000000000000000011111111111111111111000000
001100000000110011000000000000000011111111111111111111000000
001100000000000011000000000000000000000000000000000000000000
001100000000000011001111111111000000000000000000000000000000
001100000000000011001111111111000000000000000000000000000000
000000000000000011000000000000000000000011111111111111100000
000000000000000011000000000000000000000011111111111111100000
000000000000000011000000000000000000000000000000000000000000
000000000000000011000000000000000000000000000000000000000000
000000000000000011000000000000000000000000000000000000000000
000000000000000011000000001111111111000000000000000000000000
000000000000000011000000001111111111000000001111111111000000
000000000000000011000000000000000000000000001111111111000000
000000000000000011000000000000000000000000000000000000000000
000000000000000000000000000000000000000000000000000000000000
000000000000000000000000000000000000000000000000000000000000
