000000000000000000000000000000000000000000000000000000000000
000000000000000000000000000000000000000000000000000000000000
000000000000111111111111111000000000000000000000000000000000
000000000000111111111111111000000011111111111111111111000000
000000000000000000000000000000000011111111111111111111000000
000000000000000000000000000000000000000000000000000000000000
000000000000000000000000000000000000000000000000000000000000
000011111111111111111111000000000000000000000000000000000000
000011111111111111111111000000000000000000000000000000000000
000000000000000000000000000000000000111111111111111000000000
000000000000000000000000000000000000111111111111111000000000
000000000000111111111111111111110000000000000000000000000000
000000000000111111111111111111110000000000000000000000000000
000000000000000000000000000000000000000000000000000000000000
001100000000000000000000000000000000000000000000000000000000
001100110000000000000000000000000000000000000000000000000000
001100110000000000000000111111111111111000000000000000000000
001100110000000000000000111111111111111011111111111111100000
001100110000000000000000000000000000000011111111111111100000
001100110000000000000000000000000000000000000000000000000000
001100110000111111111111111111110000000000000000000000000000
001100110000111111111111111111110000000000000000000000000000
001100110000000000000000000000000000000000000000000000000000
001100110000000000000000000000000000000000000000000000000000
000000110000000000000000000000000000000000000000000000000000
000000000000000000000000000000111111111111111111110000000000
000000000000000000000000000000111111111111111111110000000000
000000000000000000000000000000000000000000000000000000000000
000000000000000000000000000000000000000000000000000000000000
000000000000000000000000000000000000000000000000000000000000
