000000000000000000000000000000000000000000000000000000000000
000000000000000000000000000000000000000000000000000000000000
001100000000000000000000000000000000001111111111111111111100
001100000000000000000000000000000000001111111111111111111100
001100000000000000000000000000000000000000000000000000000000
001100000011111111111111111111000000000000000000000000000000
001100000011111111111111111111000000000000000000000000000000
001100000000000000000000000000000000000000000000000000000000
001100000000000000000000000000000000000011111111110000000000
001100000000111111111100000000000000000011111111110000110000
001100000000111111111100000000000000000000000000000000110000
001100000000000000000000000000000000000000000000000000110000
000000000000000000000000000000111111111111111111110000110000
000000000000000000000000000000111111111111111111110000110000
000000000000000000000000000000000000000000000000000000110000
001111111111000011111111110000000000000000000000000000110000
001111111111000011111111110000000000000000000000000000110000
000000000000000000000000000000000000000000000000000000110000
000000000000000000000000000000000000111111111100000000110000
000000000000000000000011111111110000111111111100000000000000
001111111111111110000011111111110000000000000000000000000000
001111111111111110000000000000000000000000000000000000000000
000000000000000000000000000000000000000000000000000000000000
000000000000000000000000000000000000000000000000000000000000
001111111111111110000000000000000000111111111111111111110000
001111111111111110001111111111111110111111111111111111110000
000000000000000000001111111111111110000000000000000000000000
000000000000000000000000000000000000000000000000000000000000
000000000000000000000000000000000000000000000000000000000000
000000000000000000000000000000000000000000000000000000000000
