000000000000000000000000000000000000000000000000000000000000
000000000000000000000000000000000000000000000000000000000000
000000000000000000000000000000000011111111111111111111000000
000000000000000000000000000000000011111111111111111111000000
000000001100111111111111111000000000000000000000000000000000
000000001100111111111111111000000000000000000000000000000000
000000001100000000000000000000000000000000000000000000000000
000000001100000000000000000000000000000000000000000000000000
000000001100111111111111111011111111111111100000000000000000
000000001100111111111111111011111111111111100000000000000000
000000001100000000000000000000000000000000000000000000000000
001100001100000000000000000000000000000000000000000000000000
001100001100000000000000000000000000000000000000000000000000
001100001100000000000000000000000000000000000000000000000000
001100001100001111111111000000001111111111000011111111110000
001100001100001111111111000000001111111111000011111111110000
001100001100000000000000000000000000000000000000000000000000
001100001100000000000000000000000000000000000000000000000000
001100001100000000000000000000000000000000000000000000000000
001100001100000000000000000000000000000000000000000000000000
001100001100000000001111111111111111111100000000000000000000
000000001100000000001111111111111111111100000000000000000000
000000001100000000000000000000000000000000000000000000000000
000000001100000000000000000000000000000000000000000000000000
000000000000000000000000000000000000000000000000111111111100
000000000000000011111111111111111111000000000000111111111100
000000000000000011111111111111111111000000000000000000000000
000000000000000000000000000000000000000000000000000000000000
000000000000000000000000000000000000000000000000000000000000
000000000000000000000000000000000000000000000000000000000000
