000000000000000000000000000000000000000000000000000000000000
000000000000000000000000000000000000000000001100000000000000
000000000000000000000000000000111111111100001100000000000000
000000000000000000000000000000111111111100001100000000000000
000000000000000000000000000000000000000000001100000000000000
001111111111000000000000000000000000000000001100000000000000
001111111111000000000000000000000000000000001100000000000000
000000000000000000000011111111111111100000001100000011000000
000000000000000000000011111111111111100000001100000011000000
000000000000000000000000000000000000000000001100000011000000
000000000000000000000000000000000000000000001100000011000000
000000000000000000000000000000000000000000001100000011000000
000000110000000000000000000000000000000000001100000011000000
000000110000000000000000000000000000000000001100000011000000
000000110000001111111111111111111100000000001100000011001100
000000110000001111111111111111111100000000001100000011001100
000000110000000000000000000000000000000000000000000011001100
000000110000000000000000000000000000000000000000000011001100
000000110000000000000000000000000000000000000000000011001100
000000110000000000000000000000111111111111111000000011001100
000000110000000000000000000000111111111111111000000011001100
000000110000000000000000000000000000000000000000000011001100
000000110000000000000000000000000000000000000000000000001100
000000110000000000000011111111110000000000000000000000001100
000000110000000000000011111111110000111111111111111000001100
000000110000000000000000000000000000111111111111111000001100
000000110000000000000000000000000000000000000000000000001100
000000000000000000000000000000000000000000000000000000001100
000000000000000000000000000000000000000000000000000000001100
000000000000000000000000000000000000000000000000000000000000
