000000000000000000000000000000000000000000000000000000000000
000000000000000000000000000000000000000000000000000000000000
000000000000000000000000000000000000000000000000000000000000
001111111111111111111100000000000000000000000000000000000000
001111111111111111111100000000000000000000000000000000000000
000000000000000000000000000000000011111111110000000000000000
000000000000000000000000000000000011111111110000000000001100
000000000000111111111100000000000000000000000000001100001100
000000000000111111111100000000000000000000000000001100001100
000000000000000000000000000000000000000000000000001100001100
000000000000000000000000000011111111111111100000001100001100
000000000000000000000000000011111111111111100000001100001100
001100000000000000000000000000000000000000000000001100001100
001100000000000000000000000000000000000000000000001100001100
001100000011000000000000000000000000000000000000001100001100
001100000011000000000011111111111111100000000000001100001100
001100000011000000000011111111111111100000000000001100001100
001100000011000000000000000000000000000000000000000000001100
001100000011000000000000000000000000000000000000000000001100
001100000011000000000000000000000000000000001111111111001100
001100000011000000000000000000000000000000001111111111001100
001100000011000000000000000000000000000000000000000000001100
001100000011001111111111000000000000000000000000000000001100
001100000011001111111111000000000000000000000000000000001100
001100000000000000000000000000001111111111000000000000001100
001100000000000000000000000000001111111111000000000000001100
001100000000000000000000000000000000000000000000000000000000
000000000000000000000000000000000000000000000000000000000000
000000000000000000000000000000000000000000000000000000000000
000000000000000000000000000000000000000000000000000000000000
