000000000000000000000000000000000000000000000000000000000000
000000000000000000000000000000000000000000000000000000000000
000000000011000000000000001111111111111110000000111111111100
000000000011000000000000001111111111111110000000111111111100
001100000011000000000000000000000000000000000000000000000000
001100000011000000000000000000000000000000000000000000000000
001100000011000000000000000000000000000000000000000000000000
001100000011001111111111111110001111111111111110000000000000
001100000011001111111111111110001111111111111110000000000000
001100000011000000000000000000000000000000000000000000000000
001100000011000000000000000000000000000000000000000000110000
001100000011000000000000000000000000000000000000000000110000
001100000011000000000000000000000000111111111111111000110000
001100000011000000000000000000000000111111111111111000110000
000000000011001111111111111110000000000000000000000000110000
000000000011001111111111111110000000000000000000000000110000
000000000011000000000000000000000000000000000000000000110000
000000000011000000000000000000000000000000000000000000110000
000000000011000000000000000000000000000000000000000000110000
000000000011000000000000000000111111111111111111110000110000
000000000011000000000000000000111111111111111111110000000000
000000000011000000000000000000000000000000000000000000000000
000000000000000000000000000000000000000000000000000000000000
000000000000000000000000111111111111111111110000000000000000
000000000000000000000000111111111111111111110000000000000000
000000000000111111111100000000000000000000000000000000000000
000000000000111111111100000000000000000000000000000000000000
000000000000000000000000000000000000000000000000000000000000
000000000000000000000000000000000000000000000000000000000000
000000000000000000000000000000000000000000000000000000000000
