000000000000000000000000000000000000000000000000000000000000
000000000000000000000000000000000000000000000000000000000000
000011000000000000000000001111111111000000000000000000000000
000011000000000000000000001111111111000000001111111111111110
000011000011111111110000000000000000000000001111111111111110
000011000011111111110000000000000000000000000000000000000000
000011000000000000000000000000000000000000000000000000000000
000011000000000000000000000000000000000000000000000000000000
000011000000000000000000001100000000001111111111111110000000
000011000000111111111100001100000000001111111111111110000000
000011000000111111111100001100000000000000000000000000000000
000011000000000000000000001100000000000000000000000000000000
000011000000000000000000001100000000000000000000000000000000
000011000000111111111100001100000000001111111111111111111100
000011000000111111111100001100000000001111111111111111111100
000011000000000000000000001100000000000000000000000000000000
000011000000000000000000001100000000000000000000000000000000
000000000000000000000000001100000000000000000000000000000000
000000000000000000000000000000000000000000001111111111000000
000000000000000000000000000000000000000000001111111111000000
000000001111111111111110000000000000000000000000000000000000
000000001111111111111110111111111111111000000000000000000000
000000000000000000000000111111111111111000000000000000000000
000000000000000000000000000000000000000000000000000000000000
000000000000000000000000000000000000000000000000000000000000
000011111111111111100000000000000000000000001111111111000000
000011111111111111100000000000000000000000001111111111000000
000000000000000000000000000000000000000000000000000000000000
000000000000000000000000000000000000000000000000000000000000
000000000000000000000000000000000000000000000000000000000000
