000000000000000000000000000000000000000000000000000000000000
000000000000000000000000000000000000110000000000000000000000
000000000000000011111111110000000000110000000000111111111100
000000000000000011111111110000000000110000110000111111111100
001100000000000000000000000000000000110000110000000000000000
001100000000000000000000000000001100110000110000000000000000
001100000000000000000000000000001100110000110000000000000000
001100000011111111111111100000001100110000110011111111110000
001100000011111111111111100000001100110000110011111111110000
001100000000000000000000000000001100110000110000000000000000
001100000000000000000000000000001100110000110000000000000000
001100111111111111111111110000001100000000110000000000000000
001100111111111111111111110000001100000000110000000000000000
001100000000000000000000000000001100000000110011000000110000
001100000000000000000000000000001100000000110011000000110000
001100000000000000000000000000000000000000110011000000110000
001100000000000000000000000000000000000000110011000000110000
001100000000000011111111111111100000000000110011000000110000
001100000011000011111111111111100000000000110011000000110000
001100000011000000000000000000000000000000110011000000110000
001100000011000000000000000000000000000000110011000000110000
001100000011000000000000000000000000000000110011000000110000
001100000011000000000000000000000000000000110011000000110000
001100000011000011111111111111111111000000000000000000110000
000000000011000011111111111111111111000000000000000000110000
000000000011000000000000000000000000000000000000000000110000
000000000011000000000000000000000000000000000000000000110000
000000000011000000000000000000000000000000000000000000110000
000000000000000000000000000000000000000000000000000000000000
000000000000000000000000000000000000000000000000000000000000
