000000000000000000000000000000000000000000000000000000000000
000000000000000000000000000000000000000000000000000011000000
000000000000000000000000000000000000000000000000000011000000
000000000000000011111111110011111111111111100000000011000000
000000000000000011111111110011111111111111100000000011000000
000000000000000000000000000000000000000000000000000011000000
000000000000000000000000000000000000000000000000000011000000
000000000000000000000000000000000000000000000000000011000000
000000000000000000000000000011111111110000000000000011000000
000011111111111111111111000011111111110000000000000011000000
000011111111111111111111000000000000000000000000000011000000
000000000000000000000000000000000000000000000000000000000000
000000000000000000000000000000000000111111111100000000000000
000000001111111111000000000000000000111111111100000000000000
001100001111111111000000000000000000000000000000000000000000
001100000000000000000000000000000000000000000000000000000000
001100000000000000000000000000000000000000000000000000000000
001100000000000000000000000000000000111111111100000000001100
001100001100001100000000000000000000111111111100000000001100
001100001100001100000000000000000000000000000000000000001100
001100001100001100000000000000000000000000000000000000001100
001100001100001100000000000000000000000000000000000000001100
001100001100001100000011111111110000000011111111110000001100
001100001100001100000011111111110000000011111111110000001100
000000001100001100000000000000000000000000000000000000001100
000000001100001100000000000000000000000000000000000000001100
000000001100001100000000000000000000000000000000000000001100
000000001100001100000000000000000000000000000000000000000000
000000000000000000000000000000000000000000000000000000000000
000000000000000000000000000000000000000000000000000000000000
