000000000000000000000000000000000000000000000000000000000000
000000000000000000000000000000000000000000000000000000000000
000011111111110000000000111111111111111000111111111100000000
000011111111110000000000111111111111111000111111111100000000
000000000000000000000000000000000000000000000000000000000000
000000000000000000000000000000000000000000000000000000000000
000000000011111111110000000000000000000000000000000000000000
000000000011111111110000000000000000000000000000000000000000
000000000000000000000000000000000000000000000000000011000000
000000000000000000000000000000000000000000000000000011000000
000000000000000000111111111111111000000000000000000011000000
000000000000000000111111111111111000001111111111000011000000
000000000000000000000000000000000000001111111111000011000000
000000000000000000000000000000000000000000000000000011000000
000000000000000000000000000000000000000000000000000011000000
000000000000000000000000000000000000000000000000000011000000
001111111111111111111100000000000000000011111111110011000000
001111111111111111111100000000000000000011111111110011000000
000000000000000000000000001111111111000000000000000011000000
000000000000000000000000001111111111000000000000000011000000
000000000000000000000000000000000000000000000000000011000000
001111111111111110000000000000000000000000000000000011000000
001111111111111110000000000000000000000000000000000011000000
000000000000000000000000111111111111111000000000000011000000
000000000000000000000000111111111111111000000000000011000000
000000111111111111111000000000000000000000000000000011000000
000000111111111111111000000000000000000000000000000011000000
000000000000000000000000000000000000000000000000000011000000
000000000000000000000000000000000000000000000000000000000000
000000000000000000000000000000000000000000000000000000000000
