000000000000000000000000000000000000000000000000000000000000
000000000000000000000000000000000000000000000000000000000000
000000000000000000000000111111111111111111110000000000000000
000011000000000000000000111111111111111111110000000000110000
000011000000000000000000000000000000000000000000000000110000
000011000000000000000000000000000000000000000000000000110000
000011000000001111111111000000000000000000000000000000110000
000011000000001111111111000000000000000000000000000000110000
000011000000000000000000000000000000000000000000000000110000
000011000000000000000000000000000000000000000000000000110000
000011000000000000000000000000000000001111111111111110110000
000011000000000000000000000000000000001111111111111110110000
000011000000000000000000000000000000000000000000000000110000
000011000011111111111111100000000000000000000000000000110000
000011000011111111111111100000000000000000000000000000110000
000011000000000000000000000000000000110000110000000000110000
000011000000000000000000000000000000110000110000000000110000
000011000000000000000000000000000000110000110000000000110000
000011000000111111111111111111110000110000110000001100000000
000011000000111111111111111111110000110000110000001100000000
000011000000000000000000000000000000110000110000001100000000
000011000000000000000000000000000000110000110000001100000000
000011000000000000000000000000000000110000110000001100000000
000000000000000000000000000000000000110000110000001100000000
000000000011111111111111111111000000110000110000001100000000
000000000011111111111111111111000000000000000000001100000000
000000000000000000000000000000000000000000000000001100000000
000000000000000000000000000000000000000000000000001100000000
000000000000000000000000000000000000000000000000000000000000
000000000000000000000000000000000000000000000000000000000000
