000000000000000000000000000000000000000000000000000000000000
000000000000000000000000000000000000000000000000000000000000
001111111111000000000000000000000000000000000000000000000000
001111111111000000000000000000000000000000000000000000000000
000000000000000000111111111111111000000000001111111111000000
000000000000000000111111111111111000000000001111111111000000
000000000000000000000000000000000000000000000000000000000000
000000000000000000000000000000000000000000000000000000000000
000000000000000000000000000000000000000000000000000000000000
000000000000000000000000111111111111111111110000000000000000
000000111111111100000000111111111111111111110000000000110000
000000111111111100000000000000000000000000000000000000110000
000000000000000000000000000000000000000000000000000000110000
000000000000000000000000000000000000000000000000001100110000
000000000000000000000000000000001111111111111110001100110000
000000000000000000000000000000001111111111111110001100110000
000000000000001111111111000000000000000000000000001100110000
000000000000001111111111000000000000000000000000001100110000
000000000000000000000000000000111111111111111000001100110000
000000000000000000000000000000111111111111111000001100110000
000000000011111111111111100000000000000000000000001100000000
000000000011111111111111100000000000000000000000001100000000
000000000000000000000000000000000000000000000000001100000000
000000000000000000000000000000000000000000000000001100000000
000000000000000000000000000000000000000000000000001100000000
000011111111111111100011111111111111111111000000001100000000
000011111111111111100011111111111111111111000000001100000000
000000000000000000000000000000000000000000000000001100000000
000000000000000000000000000000000000000000000000000000000000
000000000000000000000000000000000000000000000000000000000000
