000000000000000000000000000000000000000000000000000000000000
000000000000000000000000000000000000000000000000000000000000
000000111111111100000000000000000000000000000000000000000000
000000111111111100000000000000000000000000000000000000000000
000000000000000000000000000000000000000000000000000000000000
000000000000000000001100000000000000001111111111111110000000
001111111111000000001100001111111111001111111111111110000000
001111111111000000001100001111111111000000000000000000000000
000000000000000000001100000000000000000000000000000000000000
000000000000000000001100000000000000000000000000000000000000
000011111111110000001100000000000000000000000000000000000000
000011111111110000001100000000000000000000000000000000000000
000000000000000000001100000000000000001111111111000000000000
000000000000000000001100111111111100001111111111000000000000
000000000000000000001100111111111100000000000000000000000000
000000000000000000000000000000000000000000000000000000000000
000000000000000000000000000000000000000000000011111111110000
000011111111110000000011111111111111100000000011111111110000
000011111111110011000011111111111111100000000000000000000000
000000000000000011000000000000000000000000000000000000000000
000000000000000011000000000000000000000000000000000000000000
000000000000000011000000000000000000000000000000000000000000
000000000000000011000000000000000000000000000000000000000000
000000000000000011000000000000000000000000000000000000000000
000000000000000011000000000000000000001111111111111111111100
000011111111110011000011111111111111101111111111111111111100
000011111111110011000011111111111111100000000000000000000000
000000000000000011000000000000000000000000000000000000000000
000000000000000000000000000000000000000000000000000000000000
000000000000000000000000000000000000000000000000000000000000
