000000000000000000000000000000000000000000000000000000000000
000000000000000000000000000000000000000000000000000000001100
000000001111111111111111111100000000000000000000000000001100
000000001111111111111111111100000000111111111111111000001100
000000000000000000000000000000000000111111111111111000001100
000000000000000000000000000000000000000000000000000000001100
000000000000000011111111111111100000000000000000000000001100
000000000000000011111111111111100000000000000000000000001100
001111111111000000000000000000000000000000111111111100001100
001111111111000000000000000000000000000000111111111100001100
000000000000000000000000000000000000000000000000000000001100
000000000000000000000000000000000011000000000000000000001100
000000000000000000000000000000000011000000000000000000001100
001111111111111111111100000000000011001111111111000000001100
001111111111111111111100000000000011001111111111000000001100
000000000000000000000000000000000011000000000000000000001100
000000000000000000000000000000000011000000000000000000000000
000000000000000000000000000000000011000000000000000000000000
000000110000000000000000000000000011000011111111111111100000
000000110000000000000000000000000011000011111111111111100000
000000110000000000000000000000000011000000000000000000000000
000000110011111111111111100000000000000000000000000000000000
000000110011111111111111100000000000000000000000000000000000
000000110000000000000000001111111111111111111100000000000000
000000110000000000000000001111111111111111111100000000000000
000000110000000000000000000000000000000000000000000000000000
000000110000000000000000000000000000000000000000000000000000
000000110000000000000000000000000000000000000000000000000000
000000000000000000000000000000000000000000000000000000000000
000000000000000000000000000000000000000000000000000000000000
