000000000000000000000000000000000000000000000000000000000000
000000000000001100000000000000000000000000000000000000000000
001111111111001100000000000000000000000000000000111111111100
001111111111001100000000000000000011111111110000111111111100
000000000000001100000000000000000011111111110000000000000000
000000000000001100000000000000000000000000000000000000000000
000000000000001100000000000000000000000000000000000000000000
000000000000001100000000000000000000000000000000000000000000
000000000000001100001111111111000000000000000000000000000000
000000000000001100001111111111000000001111111111000000000000
000000000000001100000000000000000000001111111111000000000000
000000000000000000000000000000000000000000000000000000000000
000000000000000000000000000000000000000000000000000000000000
000000000000000000000000000000001111111111111111111100000000
001111111111111111111100000000001111111111111111111100000000
001111111111111111111100000000000000000000000000000000000000
000000000000000000000000000000000000000000000000000000000000
000000000000000000000000000000001111111111111110000000000000
000000000000000000000000000000001111111111111110000000000000
000000000000000000001111111111000000000000000000000000000000
000000000000000000001111111111000000000000000000000000000000
000000000000000000000000000000000000000000000011111111110000
001111111111000000000000000000000000000000000011111111110000
001111111111000000000011111111110000000000000000000000000000
000000000000000000000011111111110000000000000000000000000000
000000000000000000000000000000000000000000000000000000000000
000000000000000000000000000000000000000000000000000000000000
000000000000000000000000000000000000000000000000000000000000
000000000000000000000000000000000000000000000000000000000000
000000000000000000000000000000000000000000000000000000000000
