000000000000000000000000000000000000000000000000000000000000
000000000000000000000000000000000000000000000000000000000000
000000000000111111111111111000000000001100000000000000000000
001100000000111111111111111000000000001100111111111100000000
001100000000000000000000000000000000001100111111111100000000
001100000000000000000000000000000000001100000000000000000000
001100001100000000001111111111111110001100000000000000000000
001100001100000000001111111111111110001100000000000000000000
001100001100000000000000000000000000001100000000000000000000
001100001100000000000000000000000000001100000000000000000000
001100001100000000000000000000000000001100111111111111111000
001100001100000000000000000000000000001100111111111111111000
001100001100000011000011111111110000000000000000000000000000
001100001100000011000011111111110000000000000000000000000000
001100001100000011000000000000000000000000000000000000000000
001100001100000011000000000000000000000000000000000000000000
001100001100000011000000000000000000000000000000000000000000
001100001100000011001111111111111111111100000000000000000000
001100001100000011001111111111111111111100001111111111111110
001100001100000011000000000000000000000000001111111111111110
001100001100000011000000000000000000000000000000000000000000
001100001100000011000000000000000000000000000000000000000000
001100001100000000000000000000000000000000000000000000000000
000000001100000000000000000000000000000000000000000000000000
000000001100000011111111111111100000001111111111111110000000
000000001100000011111111111111100000001111111111111110000000
000000000000000000000000000000000000000000000000000000000000
000000000000000000000000000000000000000000000000000000000000
000000000000000000000000000000000000000000000000000000000000
000000000000000000000000000000000000000000000000000000000000
