000000000000000000000000000000000000000000000000000000000000
000000001100000000000000000000000000000000110000000000000000
000000001100000000000000000000000000000000110000000000000000
001100001100000000111111111100000000000000110011111111110000
001100001100000000111111111100000000000000110011111111110000
001100001100000000000000000000111111111100110000000000000000
001100001100000000000000000000111111111100110000000000000000
001100001100000000000000000000000000000000110000000000000000
001100001100000000000000000000000000000000110000000000000000
001100001100000011111111110000000000000000110000000000000000
001100001100000011111111110000111111111100110000000000000000
001100000000000000000000000000111111111100000000000000000000
001100000000000000000000000000000000000000000000000000000000
000000110000000000000000000000000000000000000000000000000000
000000110000000000000000000000000000000000000000000000000000
000000110000000000000000000000000000000000000000000000000000
000000110000110000000000000000000000000000000000111111111100
000000110000110000000000000011111111111111100000111111111100
000000110000110000000000000011111111111111100000000000000000
000000110000110000000000000000000000000000000000000000000000
000000110000110000000000000000000000000000000000000000000000
000000110000110011111111110000000000000000000000000000000000
000000110000110011111111110000000000000011111111110000000000
000000110000110000000000000000000000000011111111110000000000
000000110000110000000000000000000000000000000000000000000000
000000110000110000000000000000000000000000000000000000000000
000000110000000000000000000000000000000000000000000000000000
000000110000000000000000000000000000000000000000000000000000
000000000000000000000000000000000000000000000000000000000000
000000000000000000000000000000000000000000000000000000000000
