000000000000000000000000000000000000000000000000000000000000
000000000000000000000000000000000000000000000000000000000000
000000000000000000000000000000000000000000001111111111000000
000000000000000000000000000000000000000000001111111111000000
000000000000000000000000000011111111110000000000000000000000
000000001100000000000000000011111111110000000000000000000000
000000001100111111111111111000000000000000000000110000000000
000000001100111111111111111000000000000000000000110000000000
000000001100000000000000000000000000000000000000110000000000
000000001100000000000000000000000000000000000000110000000000
000000001100000000000000000000000000000000000000110000000000
000011001100111111111100000000000000000000000000110000000000
000011001100111111111100000000000000000000001100110000001100
000011001100000000000000000000000000000000001100110000001100
000011001100000000000000000000000000000000001100110000001100
000011000000000000000000000000000000000000001100110000001100
000011000000000011111111111111111111000000001100110000001100
000011000000000011111111111111111111001100001100110000001100
000011000000000000000000000000000000001100001100110000001100
000011000000000000000000000000000000001100001100110000001100
000011000000000000000000000000000000001100001100110000001100
000011000011111111111111100000000000001100001100110000001100
000011000011111111111111100000000000001100000000110000000000
000011000000000000000000000000000000001100000000110000000000
000011000000000000000000000000000000001100000000110000000000
000011000000000011111111111111111111001100000000110000000000
000000000000000011111111111111111111001100000000000000000000
000000000000000000000000000000000000000000000000000000000000
000000000000000000000000000000000000000000000000000000000000
000000000000000000000000000000000000000000000000000000000000
