000000000000000000000000000000000000000000000000000000000000
000000000000000000000000000000000000000000000000000000000000
000000000000000000000000000000000000000000000000000000000000
000011111111111111111111000000000000111111111100000000000000
000011111111111111111111000000000000111111111100000000000000
000000000000000000000000000000000000000000000000000000000000
000000000000000000000000000000000000000000000000000000000000
000000000000000000000000000000000000000000111111111111111000
000011111111111111100000001111111111000000111111111111111000
000011111111111111100000001111111111000000000000000000000000
000000000000000000000000000000000000000000000000000000000000
000000000000000000000000000000000000001111111111000000000000
000000000000000000000000000000000000001111111111000000000000
000000000000000000111111111100000000000000000000000000000000
001111111111000000111111111100000000000000000000000000000000
001111111111000000000000000000000000000000000000000000000000
000000000000000000000000000000000000000000000000111111111100
000000000000000000000000000000000000000000000000111111111100
000000000000000011111111110000000000000000000000000000000000
001111111111000011111111110000000000000000000000000000000000
001111111111000000000000000000000000000000000000000000000000
000000000000000000000000000000000000000000000000000000000000
000000000000000000000000000000000000000000000000000000000000
000000111111111111111000000000000000000000000000000000000000
000000111111111111111000111111111100000000000000000000000000
000000000000000000000000111111111100111111111111111000000000
000000000000000000000000000000000000111111111111111000000000
000000000000000000000000000000000000000000000000000000000000
000000000000000000000000000000000000000000000000000000000000
000000000000000000000000000000000000000000000000000000000000
