000000000000000000000000000000000000000000000000000000000000
000000000000000000000000000000000000000000000000000000000000
000000000000000000000000000000000000000000000000000000000000
000000000000000000000000000000000000000000111111111100000000
000000000000000000111111111100000000000000111111111100000000
000000000000000000111111111100000000000000000000000000000000
001111111111000000000000000000000000000000000000000000000000
001111111111000000000000000000000000000000000000000000000000
000000000000000000000000000000000000001111111111111111111100
000000000000000000000000000000000000001111111111111111111100
000000000000000000000000000000000000000000000000000000000000
000000000000000000000000000000000000000000000000000000000000
000000000011111111111111100000001111111111111111111100001100
000000000011111111111111100000001111111111111111111100001100
001100000000000000000000000000000000000000000000000000001100
001100000000000000000000000000000000000000000000000000001100
001100000000000000000000000000000000000000000000000000001100
001100110000000000000000000000000000000011111111110000001100
001100110000000000110000000000000000000011111111110000001100
001100110000000000110000000000000000000000000000000000001100
001100110000000000110000000000000000000000000000000000001100
001100110000000000110000000000000000000000000000000000001100
001100110000000000110000000000000000000000000000000000001100
001100110000000000110000000000111111111111111000000000001100
001100110000000000110000000000111111111111111000000000001100
001100110000000000110000000000000000000000000000000000001100
001100110000000000110000000000000000000000000000000000001100
001100000000000000110000000000000000000000000000000000000000
001100000000000000000000000000000000000000000000000000000000
000000000000000000000000000000000000000000000000000000000000
