000000000000000000000000000000000000000000000000000000000000
000000000000000000000000000000000000000000000000000000000000
000000000000000000000000001111111111001111111111111111111100
000000000000000000000000001111111111001111111111111111111100
000000110000000000000000000000000000000000000000000000000000
001100110000000000000000000000000000000000000000000000000000
001100110000000000000000000000000000000000000000000000000000
001100110000111111111111111111110000000000000000000000001100
001100110000111111111111111111110000000000000000001100001100
001100110000000000000000000000000000000000000000001100001100
001100110000000000000000000000000000000000000000001100001100
001100110000000000000000000000000000000000000000001100001100
001100110000000000000000000000000000000000000000001100001100
001100110000000000000000000000111111111111111000001100001100
001100110000000000000000000000111111111111111000001100001100
000000110000000000000000000000000000000000000000001100001100
000000110000000000000000000000000000000000000000001100001100
000000110000111111111100000000000000000000000000001100001100
000000110000111111111100001111111111000000000000001100001100
000000110000000000000000001111111111000000000000001100001100
000000110000000000000000000000000000000000000000001100001100
000000110000000000000000000000000000000000000000001100001100
000000110000000000000000000000000011111111111111101100000000
000000110000000000000000000000000011111111111111101100000000
000000000000000000000000000000000000000000000000001100000000
000000000000000011111111111111100000000000000000001100000000
000000000000000011111111111111100000000000000000001100000000
000000000000000000000000000000000000000000000000001100000000
000000000000000000000000000000000000000000000000000000000000
000000000000000000000000000000000000000000000000000000000000
