000000000000000000000000000000000000000000000000000000000000
000000000000000000000000000000000000000000000000000000000000
000011000000110000000000000000000000000000000000000000000000
000011000000110000000000000000000000000000000000000000000000
000011000000110000000000000000000000000000000000000000000000
000011000000110000001111111111000011111111111111111111000000
000011000000110000001111111111000011111111111111111111000000
000011000000110000000000000000000000000000000000000000000000
000011000000110000000000000000000000000000000000000000000000
000011000000110000000000000000000000000000000000000000000000
000011000000110000000000000000000000000000000000000000000000
000011000000110000000000000000000000000000000000000000000000
000000000000110000001111111111111111111100000000000000000000
000000000000110000001111111111111111111100001111111111000000
000000000000110000000000000000000000000000001111111111000000
000000000000110000000000000000000000000000000000000000000000
000000000000110000000000000000000000000000000000000000000000
000000000000000000000011111111110000000000111111111100000000
000000000000000000000011111111110000000000111111111100000000
000000000000000000000000000000000000000000000000000000000000
000000000000000000000000000000000000000000000000000000000000
000000000000000000000011111111111111100000000000000000000000
000000000000000000000011111111111111100000000000000000000000
000000000000000000000000000000000000000000000000000000000000
000000001111111111000000000000000000000000000000000000000000
000000001111111111000000000000000000000000000011111111110000
000000000000000000000000000000000000000000000011111111110000
000000000000000000000000000000000000000000000000000000000000
000000000000000000000000000000000000000000000000000000000000
000000000000000000000000000000000000000000000000000000000000
