000000000000000000000000000000000000000000000000000000000000
000000000000000000000000000000000000000000000000000000000000
000000000000000000000000000000000000000000000000110011000000
000000000000000000000000000000000000000011000000110011000000
000000000011111111111111101111111111000011000000110011000000
000000000011111111111111101111111111000011000000110011000000
000000000000000000000000000000000000000011000000110011000000
000000000000000000000000000000000000000011000000110011000000
000000000000000000000000000000000011000011000000110011000000
000000000000000000000000000000000011000011000000110011000000
000000111111111100111111111111111011000011000000110011000000
000000111111111100111111111111111011000011001100110011000000
000000000000000000000000000000000011000011001100000011000000
000000000000000000000000000000000011000011001100000011000000
000011000000000011111111111111100011000011001100000011000000
000011000000000011111111111111100011000011001100000011000000
000011000000000000000000000000000011000011001100000011000000
000011000000000000000000000000000011000011001100000011000000
000011000000110000000000000000000011000011001100000011000000
000011000000110011111111110000000011000011001100000011000000
000011000000110011111111110000000011000011001100000011000000
000011000000110000000000000000000011000011001100000011000000
000011000000110000000000000000000011000011001100000000000000
000011000000110000000000000000000011000000001100000000000000
000011000000110011111111110000000011000000001100000000000000
000011000000110011111111110000000011000000001100000000000000
000011000000110000000000000000000011000000000000000000000000
000011000000110000000000000000000011000000000000000000000000
000011000000000000000000000000000000000000000000000000000000
000000000000000000000000000000000000000000000000000000000000
