000000000000000000000000000000000000000000000000000000000000
000000000000000000000000000000000000000000000000000000000000
000000001111111111111110000000000000001111111111111111111100
000000001111111111111110000000000000001111111111111111111100
000000000000000000000000000000000000000000000000000000000000
000000000000000000000000110000000000000000000000000000000000
000000000000000000000000110000000000000000000000000000000000
000000000000000000000000110000000000000000000000000000000000
000000000000000000000000110000000000000000001111111111111110
000000000000000000000000110000000000000000001111111111111110
000000111111111100001100110000110000000000000000000000000000
000000111111111100001100110000110000000000000000000000000000
000000000000000000001100110000110000000000000000000000000000
000000000000000000001100110000110000000000000000000000000000
000000000000000000001100110000110011111111111111111111000000
000000000000000000001100000000110011111111111111111111000000
001111111111111110001100000000110000000000000000000000000000
001111111111111110001100000000110000000000000000000000000000
000000000000000000001100000000110000000000000000000000000000
000000000000000000001100000000110000000000000000000000000000
000000000000000000000000000000000000000000000000000000000000
000000000000000000000000000000000000000000000000000000000000
000000000000111111111111111111110000000011111111110000000000
000000000000111111111111111111110000000011111111110000000000
000000000000000000000000000000000000000000000000000000000000
000000000000000000000000000000000000000000000000000000000000
000000000000000000000000000000000000000000000000000000000000
000000000000000000000000000000000000000000000000000000000000
000000000000000000000000000000000000000000000000000000000000
000000000000000000000000000000000000000000000000000000000000
