000000000000000000000000000000000000000000000000000000000000
000000000000000000000000000000000000000000000000000000000000
000000000000000000000000000000000000000000000000000000000000
000000000000000000000000000000000000000000000000000000000000
001100111111111100000000000000000000111111111100000000000000
001100111111111100000000000000000000111111111100001100000000
001100000000000000000000000000000000000000000000001100001100
001100000000000000000000000000000000000000000000001100001100
001100000000000000000000000000000000000000000000001100001100
001100000000000000000000000000000000000000000000001100001100
001100000000000000001111111111111111111100000000001100001100
001100001111111111001111111111111111111100000000001100001100
001100001111111111000000000000000000000000000000001100001100
001100000000000000000000000000000000000000000000001100001100
001100000000000000000000000000000000000000000000001100001100
001100000000000000000000000000111111111100000000000000001100
001100000000000000000000000000111111111100000000000000000000
001100000000000000000000000000000000000000000000000000000000
001100000000000011111111110000000000000000000000000000000000
001100000000000011111111110000000000001111111111111111111100
001100000000000000000000000000000000001111111111111111111100
001100000000000000000000000000000000000000000000000000000000
001100000000000000000000000000000000000000000000000000000000
001100111111111111111000000000000000000000000000000000000000
000000111111111111111000000000000000000000000000000000000000
000000000000000000000000111111111111111111110000000000000000
000000000000000000000000111111111111111111110000000000000000
000000000000000000000000000000000000000000000000000000000000
000000000000000000000000000000000000000000000000000000000000
000000000000000000000000000000000000000000000000000000000000
