000000000000000000000000000000000000000000000000000000000000
000000000000000000000000000000000000000000000011000000000000
000000000000000000000000000000000000000000000011000000000000
000000000000000000000000000000000000000000000011000000000000
000000000000000000000000000000000000000000000011000000000000
000000111111111111111000000011111111111111100011000000110000
000000111111111111111000000011111111111111100011000000110000
000000000000000000000000000000000000000000000011000000110000
000000000000000000000000000000000000000000000011000000110000
000000000000000000000000000000000000000000000011000000110000
001111111111000000000000000000000000000000000011000000110000
001111111111000000000000000000000000000000000000000000110000
000000000000000000000000000000000011111111110000000000110000
000000000000000011111111111111100011111111110000000000110000
000000000000000011111111111111100000000000000000000000110000
000000000000000000000000000000000000000000000000000000000000
000000000000000000000000000000000000000000000000000000000000
000000000000000000000000000000000000000000000000000000000000
001111111111111110000000000000000000000000000000000000000000
001111111111111110000000000000001111111111111110000000000000
000000000000000000000000000000001111111111111110000000000000
000000000000000000000000000000000000000000000000000000000000
000000000000000000000000000000000000000000000000000000000000
000000000000000000000000000000000000000000001111111111111110
000000000000000000000000000000000000000000001111111111111110
000000111111111100001111111111111111111100000000000000000000
000000111111111100001111111111111111111100000000000000000000
000000000000000000000000000000000000000000000000000000000000
000000000000000000000000000000000000000000000000000000000000
000000000000000000000000000000000000000000000000000000000000
