000000000000000000000000000000000000000000000000000000000000
000000000000000000000000000000000000000000000000000000000000
001100000000000011111111111111111111000000111111111111111000
001100000000000011111111111111111111000000111111111111111000
001100000000000000000000000000000000000000000000000000000000
001100000000000000000000000000000000000000000000000000000000
001100000000000000111111111100000000000000000000000000000000
001100000000000000111111111100000000000000000000000000000000
001100000000000000000000000000000011111111111111111111000000
001100000000000000000000000000000011111111111111111111000000
001100111111111111111000000000000000000000000000000000000000
001100111111111111111000000000000000000000000000000000000000
001100000000000000000000000000000000000000000000000000000000
001100000000000000000000000000000000000000000000000000000000
001100000000000000000000000000000000000000000000110000000000
001100000000000000000000000000000000000000000000110000000000
001100000000000000000000000000000000000000000000110000000000
001100111111111111111111110000000011111111110000110000000000
001100111111111111111111110000000011111111110000110000001100
001100000000000000000000000000000000000000000000110000001100
001100000000000000000000000000000000000000000000110000001100
001100000000000000000000000000000000000000000000110000001100
000000000000000000000000000000000000000000000000110000001100
000000000011111111110000001111111111000000000000110000001100
000000000011111111110000001111111111000000000000110000001100
000000000000000000000000000000000000000000000000110000001100
000000000000000000000000000000000000000000000000110000001100
000000000000000000000000000000000000000000000000110000001100
000000000000000000000000000000000000000000000000110000000000
000000000000000000000000000000000000000000000000000000000000
