000000000000000000000000000000000000000000000000000000000000
000000000000000000000000000000000000000000000000000000000000
000000000000000000000000000000000000000000000011111111110000
001111111111001111111111111111111100000000000011111111110000
001111111111001111111111111111111100000000000000000000000000
000000000000000000000000000000000000000000000000000000000000
000000000000000000000000000000000000000000000000000000000000
000000000000000000000000000000000000000000000000000000000000
001111111111000000000000000000000000000000000000000000000000
001111111111000000001111111111111110001111111111111111111100
000000000000000000001111111111111110001111111111111111111100
000000000000000000000000000000000000000000000000000000000000
000000000000000000000000000000000000000000000000000000000000
000000111111111100000000000000000000000000000000000000000000
000000111111111100000000000000000000111111111111111111110000
000000000000000000000000001100001100111111111111111111110000
000000000000000000000000001100001100000000000000000000000000
000000000000000000000000001100001100000000000000000000000000
000011000000000000000000001100001100000000000000000000000000
000011000000111111111100001100001100000000000000000000000000
000011000000111111111100001100001100000000000000000000000000
000011000000000000000000001100001100000000000000000000000000
000011000000000000000000001100001100111111111111111111110000
000011000000000000000000001100001100111111111111111111110000
000011000000001111111111001100001100000000000000000000000000
000011000000001111111111000000000000000000000000000000000000
000011000000000000000000000000000000000000000000000000000000
000011000000000000000000000000000000000000000000000000000000
000000000000000000000000000000000000000000000000000000000000
000000000000000000000000000000000000000000000000000000000000
