000000000000000000000000000000000000000000000000000000000000
000000000000000000000000000000000000000000000000000000000000
000011111111111111111111000011001100000000000000000000000000
000011111111111111111111000011001100000000000000000000000000
000000000000000000000000000011001100000000001111111111111110
000000000000000000000000000011001100000000001111111111111110
000000000000000000000000000011001100000000000000000000000000
000000000000001111111111000011001100000000000000000000000000
000000000000001111111111000011001100000000000000000000000000
000000000000000000000000000011001100001111111111111111111100
000000000000000000000000000011001100001111111111111111111100
000000000000000000000000000011001100000000000000000000000000
000000000000000000000000000000001100000000000000000000000000
000000000000000000000000000000001100000000000011111111110000
000000000000000000000000000000001100000000000011111111110000
000000111111111111111111110000001100000000000000000000000000
000000111111111111111111110000001100000000000000000000000000
000000000000000000000000000000000000000000000000000000000000
000000000000000000000000000000000000001111111111000000000000
000000000000000000000000000000000000001111111111000000000000
000000000000001111111111111110000000000000000000000000000000
000000000000001111111111111110000000000000000000000000000000
000000000000000000000000000000000000111111111111111111110000
000000000000000000000000000000000000111111111111111111110000
000000000000000000000000000000000000000000000000000000000000
000011111111111111111111000000000000000000000000000000000000
000011111111111111111111000000000000000000000000000000000000
000000000000000000000000000000000000000000000000000000000000
000000000000000000000000000000000000000000000000000000000000
000000000000000000000000000000000000000000000000000000000000
