000000000000000000000000000000000000000000000000000000000000
000000000000000000000000000000001100000000000000000000000000
000000000000000000000000000000001100000000000000111111111100
000011000000000000000000000000001100000000000000111111111100
000011000000000011000000000000001100000000000000000000000000
000011000000000011000000000000001100000000000000000000000000
000011000000000011000000000000001100000000001111111111111110
000011000000000011000000000000001100000000001111111111111110
000011000000110011000000000000001100000000000000000000000000
000011000000110011000000000000001100000000000000000000000000
000011000000110011000000000011001100000000000000000000000000
000011000000110011000000000011000000000000000000000000000000
000011000000110011000011000011000000111111111100000000000000
000000000000110011000011000011000000111111111100000000000000
000000000000110011000011000011000000000000000000000000000000
000000000000110011000011000011000000000000000000000000000000
000000000000110011000011000011000000000000000000000000000000
000000000000110011000011000011000000000000000000000000000000
000000110000000011000011000011000000001111111111111111111100
000000110000000011000011000011000000001111111111111111111100
000000110000000011000011000011000000000000000000000000000000
000000110000000011000011000011000000000000000000000000000000
000000110000000011000000000011001111111111000000000000000000
000000110000000011000000000011001111111111000000000000000000
000000110000000000000000000011000000000000000011111111110000
000000110000000000000000000000000000000000000011111111110000
000000110000000000000000000000000000000000000000000000000000
000000110000000000000000000000000000000000000000000000000000
000000000000000000000000000000000000000000000000000000000000
000000000000000000000000000000000000000000000000000000000000
