000000000000000000000000000000000000000000000000000000000000
000000000000000000000000000000000000000000000000000000000000
000000000000000000000000000000000000000000000000000000000000
000000000000000000000000000000000000000011111111111111100000
000000000000111111111111111111110000110011111111111111100000
000000000000111111111111111111110000110000000000000000000000
000000000000000000000000000000000000110000000000000000000000
000000000000000000000000000000000000110000000000000000000000
000000000000000000000000000000000000110000000000000000001100
000000000000000000000000000000000000110000000000000000001100
000000000000000000111111111100000000110000001111111111001100
000000000000000000111111111100110000110000001111111111001100
000011000000000000000000000000110000110000000000000000001100
000011000000000000000000000000110000110000000000000000001100
000011000000000000000000000000110000000000000000000000001100
000011000000000000000000000000110000000000000000000000001100
000011000000000000000000000000110000000000000000000000001100
000011000000001111111111000000110000001111111111111110001100
000011000000001111111111000000110000001111111111111110001100
000011000000000000000000000000110000000000000000000000001100
000011000000000000000000000000110000000000000000000000001100
000011000011111111111111100000110000000000000000000000001100
000011000011111111111111100000110000000000000000000000001100
000011000000000000000000000000110000111111111111111000001100
000011000000000000000000000000110000111111111111111000001100
000011000000000000000000000000110000000000000000000000001100
000011000000000000000000000000000000000000000000000000001100
000000000000000000000000000000000000000000000000000000001100
000000000000000000000000000000000000000000000000000000000000
000000000000000000000000000000000000000000000000000000000000
