000000000000000000000000000000000000000000000000000000000000
000000000000000000000000000000000000000000000000000000000000
000000000000000000000000000011111111111111111111000000000000
001100000000000000000000000011111111111111111111000000000000
001100000000000000000000000000000000000000000000000000000000
001100000000000000000000000000000000000000000000000000000000
001100000000111111111111111111110000000000000000000000000000
001100000000111111111111111111110000000000000000000000000000
001100000000000000000000000000000000000000000000001100001100
001100110000000000000000000000000000000000000000001100001100
001100110000000000000000000000000000000000000000001100001100
001100110000000011111111111111111111000000000000001100001100
001100110000000011111111111111111111000000000000001100001100
000000110000000000000000000000000000000000000000001100001100
000000110000110000000000000000000000000000000000001100001100
000000110000110000000000000000000000000000000000001100001100
001100110000110000000000000000000000000000000000001100001100
001100110000110000000000000000000000000000000000001100001100
001100110000110000000000001111111111111110000000000000000000
001100110000110000000000001111111111111110000000000000000000
001100110000110000000000000000000000000000000000000000000000
001100110000110000000000000000000000000000001111111111000000
001100110000110000000000000000000000000000001111111111000000
001100110000110000000000000000000000000000000000000000000000
001100000000110000000000000000000000000000000000000000000000
001100000000110000001111111111111111111100000000000000000000
000000000000110000001111111111111111111100000000000000000000
000000000000110000000000000000000000000000000000000000000000
000000000000110000000000000000000000000000000000000000000000
000000000000000000000000000000000000000000000000000000000000
