000000000000000000000000000000000000000000000000000000000000
000000000000000000000000000000000000000011000000000000000000
000000000000000000000000000000000000000011000000000011000000
000000000000000000000000000000000000000011000011000011000000
000000000000001111111111111111111100000011000011000011000000
000011000000001111111111111111111100000011000011000011000000
000011000000000000000000000000000000000011000011000011000000
000011000000000000000000000000000000000011000011000011000000
000011000000000000000000000000000000000011000011000011000000
000011000000000000000000000000000000000011000011000011000000
000011000000000000000000000000000000000011000011000011000000
000011000000000000000000000000000000000011000011000011000000
000011000011111111111111100000000000000011000011000000000000
000011000011111111111111100000000000000011000000000000000000
000011000000000000000000001111111111000011000000000000000000
000011000000000000000000001111111111000011000000000000000000
000011000000000000000000000000000000000000001111111111000000
000011000000000000000000000000000000000000001111111111000000
000011000000000000000000000000000000000000000000000000000000
000011000000000000000000000000000000000000000000000000000000
000000000000111111111111111000000000000000000000000000000000
000000000000111111111111111000000000000000111111111100000000
000000000000000000000000000000000000000000111111111100000000
000000000000000000000000000000000000000000000000000000000000
000000000000000000000000000000000000000000000000000000000000
000000000000111111111100000000111111111100000000000000000000
000000000000111111111100000000111111111100000000000000000000
000000000000000000000000000000000000000000000000000000000000
000000000000000000000000000000000000000000000000000000000000
000000000000000000000000000000000000000000000000000000000000
